tidligere = former
varigt = permanently
anklagerne = the charges
sikkert = safe
frivilligt = voluntarily
bryder = breaks
forlanger = demands
udfordring = challenge
meddelte = announced
væsentlig = significant
smerten = the pain
grænsen = the border
stramning = tightening
meldinger = reports
værter = hosts
nægter = refuses
udbytte = yield
opsigtvækkende = sensational
bevis = proof
enig = agree
nedværdigende = degrading
skæbne = fate
enkelt = single
mønster = pattern
tilsyneladende = apparently
afventer = awaits
overordentlig = extremely
fuldstændig = complete
begrænsninger = limitations
påvirke = influence
afgørelse = decisions
høster = harvests
lover = promise
fremlægge = present
lejlighed = apartment
skuffende = disappointing
fremtid = future
afviser = rejects
aflyste = cancelled
ansøge = apply
angrebet = attacked
henvendelser = inquiries
sen = late
slukker = turns off
efterforskning = investigation
forholdene = the conditions
tegn = sign
at_regne_ud = calculate
fremlagt = submitted
almindelige = ordinary
anholdelser = arrests
knaphed = scarcity
undgå = avoid
lignende = similar
gavmilde = generous
nemlig = exactly
udtryk = expression
straffe = punish
behandling = treatment
revser = punishes
begejstring = excitement
fordømmer = condemns
hændelse = incident
stortest = pretty much
væsen = nature
samtale = conversation
eftersom = since
udbredt = widespread
ansvar = responsibility
slog_fast = stated
afbøde = mitigate
myndigheder = authorities
førende = leading
tåbelige = foolish
stram = strict
gengæld = in return
beviste = conscious
forsøg = attempt
godkendt = approved
stigende = increasing
skyldes = due to
kølvandet = the aftermath
gevinster = winnings
udbygge = expand
berørt = affected
slutningen = the end
mening = mind
lindre = ease
særligt = particularly
