bider = bite
forstyrre = disturb
fisse = pussy
rive = rip
fabrik = factory
strygejern = iron
skuret = the shed
krydret = spicy
ansætte = hire
gift = married
narrøv = fool
tosset = crazy
lugter = smells
sart = delicate
glo = stare
bollerne = the buns
fejrer = celebrating
forleden = the other day
pøj pøj = good luck
skaffe = provide
frisør = hairdresser
taknemlige = grateful
frisk = fresh
frækkert = naughty
behandling = treatment
skaffer = provide
røveri = robbery
forhold jer roligt = keep calm
gipsen = the plaster
varselsskud = warning shot
genialt = genius
tænde = turn on
anmoder = requesting
skifter = changing
afspærringen = the blockade
uden om = around
forkælede = spoiled
møgunge = brat
hjerteanfald = heart attack
arbejdsro = peace of mind
sygeplejerske = nurse
krydset = crossed
nægtede = refused
klister = sticky
regelmæssigt = regularly
gidsler = hostages
båre = stretcher
forhandle = negotiate
skovtur = picnic
rattet = the steering wheel
overgive = surrender