tæppe = blanket
afsted = away
forladt = left
bestil = order
kasse = box
mulighed = possibility
glem = forget
ligegyldige = irrelevant
tilgængelig = available
tilbyder = offers
tvunget = forced
antaget = assumed
sandt = true
retfærdig = fair
dybt = deep
sikre = sure
svag = weak
kedeligt = boring
fordele = benefits
indsats = effort
besked = message
kanal = channel
svigter = fails
øvelse = practice
endnu = yet
forrige = previous
beskidt = dirty
legeme = body
forkert = wrong
forbedre = improve
optrådte = performed
overvej = consider
nogensinde = ever
ansøge = apply
vente = wait
opnå = achieve
gulv = floor
dog = however
udsende = send out
undervurderet = underestimated
berørt = affected
besluttede = decided
sjældent = rare
pressemeddelelse = press release
peger = points
sage = case
diskuteret = discussed
offentligheden = the public
række = line
deltaget = participated
måde = manner
sidste = last
helt = hero
klar = ready
årsager = reasons
påfaldende = conspicuous
fortsat = continue
ubesvarede = unanswered
forsøg = attempt
sprede = spread
frygt = fear
vurderer = evaluates
adjunkt = assistant professor
forsvar = defense
ondsindede = malicious
hensigter = intentions
yderligere = further
usikkerhed = uncertainty
leverance = delivery
henblik = purpose
hændelse = incident
meldinger = reports
bekræfte = confirm
oplysninger = information
utilfreds = dissatisfied
mindske = decrease
tønder = barrels
tilfreds = satisfied
forbrugerne = the consumers
steget = increased
laveste = lowest
mængde = amount
forenede = united
ifølge = according
breder = widens
kraftig = heavy
revanche = revenge
kendisser = celebrities
sagsøge = sue
krænkelser = violations
fred = peace
anklagerne = the charges
efterlignet = imitated
indhente = attain
udbygge = expand
bryder = breaks
tavshed = silence
snyde = cheat
flytte = move
forsinket = delayed
uafgjort = draw
påvirke = influence
beskadige = damaged
forsker = research
voldsomme = violent
sprængningerne = the explosions
bro = bridge
villighed = willingness
slutningen = the end
lækkede = leaked
myndigheder = authorities
bevidste = conscious
handlinger = actions
sen = late
ført = led
revser = punishes
tilhængere = supporters
førende = leading
deler = shares
værter = hosts
omdrejningspunkter = pivot points
bar = wearing
ryste = shake
svært = difficult
tæt = close
afbøde = mitigate
opsigtsvækkende = sensational
kølvandet = the aftermath
tilsyneladende = apparently
udtryk = expression
bevis = proof
lindre = ease
smerten = the pain
meddelte = announced
gengæld = in return
angrebet = attacked
begejstring = excitement
skuffende = disappointing
gavmilde = generous
væsen = nature
godkendt = approved
slog fast = stated
knaphed = scarcity
varer = goods
stigende = increasing
høster = harvests
nemlig = exactly
udbytte = yield
lignende = similar
overordentlig = extremely
udbredt = widespread
slukker = turns off
afviser = rejects
ansvar = responsibility
grænsen = the border
nægter = refuses
kendskab = knowledge
eftersom = since
fremlægge = present
fordømmer = condemns
nedværdigende = degrading
behandling = treatment
forlanger = demands
efterforskning = investigation
tidligere = former
fuldstændig = complete
anholdelser = arrests
tegn = sign
mønster = pattern
enig = agree
afgørelse = decisions
tåbelige = foolish
gevinster = winnings
stram = strict
fremtid = future
stadig = still
mening = mind
kendskab = knowledge
flygtninge = refugees
lover = promise
forholdene = the conditions
varigt = permanently
stort set = pretty much
sikkert = safe
straffe = punish
betyder = means
afventer = awaits
almindelige = ordinary
lejlighed = apartment
henvendelser = inquiries
skæbne = fate
frivilligt = voluntarily
stramning = tightening
fremlagt = submitted
aflyste = cancelled
samtale = conversation
udfordring = challenge
skyldes = due to
særligt = particularly
press = pressure
oplevet = experienced
ilt = oxygen
enkelt = single
faktisk = actually
væsentlig = significant
begrænsninger = limitations
niveau = level
at_regne_ud = calculate
ejer = owner
undgå = avoid
hylder = shelves
opfordret = encouraged
lagting = parliament
genoptaget = resumed
