varigt = permanently
forlanger = demands
udfordring = challenge
meddelte = announced
væsentlig = significant
værter = hosts
nægter = refuses
opsigtvækkende = sensational
tilsyneladende = apparently
fremlægge = present
fremtid = future
afviser = rejects
aflyste = cancelled
henvendelser = inquiries
forholdene = the conditions
fremlagt = submitted
almindelige = ordinary
lignende = similar
udtryk = expression
slog_fast = stated
afbøde = mitigate
gengæld = in return
beviste = conscious
godkendt = approved
udbygge = expand
lindre = ease
særligt = particularly
opfordret = encouraged
allerhelst = preferably
afsløre = reveal
vegne = behalf
betragte = consider
løgne = lies
usædvanlig = unusual
lagting = parliament
genoptaget = resumed